"filename", "language", "JavaScript", "JavaScript JSX", "comment", "blank", "total"
"c:\Users\gk725\Desktop\Gautam\Ecommerce\react-ecommerce\src\App.js", "JavaScript", 41, 0, 0, 0, 41
"c:\Users\gk725\Desktop\Gautam\Ecommerce\react-ecommerce\src\app\store.js", "JavaScript", 2, 0, 0, 0, 2
"c:\Users\gk725\Desktop\Gautam\Ecommerce\react-ecommerce\src\components\AdminProductForm.jsx", "JavaScript JSX", 0, 238, 0, 6, 244
"c:\Users\gk725\Desktop\Gautam\Ecommerce\react-ecommerce\src\components\ButtonPrimary.jsx", "JavaScript JSX", 0, 5, 0, 2, 7
"c:\Users\gk725\Desktop\Gautam\Ecommerce\react-ecommerce\src\components\ProtectedAdmin.jsx", "JavaScript JSX", 0, 13, 0, 4, 17
"c:\Users\gk725\Desktop\Gautam\Ecommerce\react-ecommerce\src\components\Rating.jsx", "JavaScript JSX", 0, 1, 0, 0, 1
"c:\Users\gk725\Desktop\Gautam\Ecommerce\react-ecommerce\src\features\NavBar\NavBar.jsx", "JavaScript JSX", 0, 1, 0, 0, 1
"c:\Users\gk725\Desktop\Gautam\Ecommerce\react-ecommerce\src\features\ProductsList\components\ProductCard.jsx", "JavaScript JSX", 0, 8, 0, 0, 8
"c:\Users\gk725\Desktop\Gautam\Ecommerce\react-ecommerce\src\features\ProductsList\components\ProductCard3.jsx", "JavaScript JSX", 0, -1, 0, 0, -1
"c:\Users\gk725\Desktop\Gautam\Ecommerce\react-ecommerce\src\features\ProductsList\components\ProductCardAdmin.jsx", "JavaScript JSX", 0, 82, 0, 3, 85
"c:\Users\gk725\Desktop\Gautam\Ecommerce\react-ecommerce\src\features\ProductsList\components\ProductItem.jsx", "JavaScript JSX", 0, 7, 0, 1, 8
"c:\Users\gk725\Desktop\Gautam\Ecommerce\react-ecommerce\src\features\ProductsList\components\ProductItemAdmin.jsx", "JavaScript JSX", 0, 89, 0, 11, 100
"c:\Users\gk725\Desktop\Gautam\Ecommerce\react-ecommerce\src\features\ProductsList\components\ProductListAdmin.jsx", "JavaScript JSX", 0, 20, 0, 4, 24
"c:\Users\gk725\Desktop\Gautam\Ecommerce\react-ecommerce\src\features\ProductsList\productListSlice.js", "JavaScript", -1, 0, 0, 1, 0
"c:\Users\gk725\Desktop\Gautam\Ecommerce\react-ecommerce\src\features\adminProduct\adminProductApi.js", "JavaScript", 25, 0, 0, 1, 26
"c:\Users\gk725\Desktop\Gautam\Ecommerce\react-ecommerce\src\features\adminProduct\adminProductSlice.js", "JavaScript", 55, 0, 0, 5, 60
"c:\Users\gk725\Desktop\Gautam\Ecommerce\react-ecommerce\src\features\auth\authApi.js", "JavaScript", 2, 0, 0, 0, 2
"c:\Users\gk725\Desktop\Gautam\Ecommerce\react-ecommerce\src\features\auth\authSlice.js", "JavaScript", 7, 0, 0, 0, 7
"c:\Users\gk725\Desktop\Gautam\Ecommerce\react-ecommerce\src\features\auth\components\Forgot.jsx", "JavaScript JSX", 0, 27, 0, 3, 30
"c:\Users\gk725\Desktop\Gautam\Ecommerce\react-ecommerce\src\features\auth\components\Logout.jsx", "JavaScript JSX", 0, 15, 0, 4, 19
"c:\Users\gk725\Desktop\Gautam\Ecommerce\react-ecommerce\src\features\cart\components\CartEmpty.jsx", "JavaScript JSX", 0, 3, 0, 0, 3
"c:\Users\gk725\Desktop\Gautam\Ecommerce\react-ecommerce\src\features\cart\components\CartList.jsx", "JavaScript JSX", 0, 2, 0, 0, 2
"c:\Users\gk725\Desktop\Gautam\Ecommerce\react-ecommerce\src\features\order\orderSlice.js", "JavaScript", 1, 0, 0, -1, 0
"c:\Users\gk725\Desktop\Gautam\Ecommerce\react-ecommerce\src\features\user\userSlice.jsx", "JavaScript JSX", 0, 4, 0, 0, 4
"c:\Users\gk725\Desktop\Gautam\Ecommerce\react-ecommerce\src\features\wishlist\WishEmpty.jsx", "JavaScript JSX", 0, 3, 0, 0, 3
"c:\Users\gk725\Desktop\Gautam\Ecommerce\react-ecommerce\src\hooks\useAuth.jsx", "JavaScript JSX", 0, 1, 0, 0, 1
"c:\Users\gk725\Desktop\Gautam\Ecommerce\react-ecommerce\src\hooks\useUser.jsx", "JavaScript JSX", 0, 11, 0, -1, 10
"c:\Users\gk725\Desktop\Gautam\Ecommerce\react-ecommerce\src\pages\Addresses.jsx", "JavaScript JSX", 0, -5, 0, -3, -8
"c:\Users\gk725\Desktop\Gautam\Ecommerce\react-ecommerce\src\pages\AdminAddProduct.jsx", "JavaScript JSX", 0, 36, 0, 5, 41
"c:\Users\gk725\Desktop\Gautam\Ecommerce\react-ecommerce\src\pages\AdminProductEdit.jsx", "JavaScript JSX", 0, 49, 0, 5, 54
"c:\Users\gk725\Desktop\Gautam\Ecommerce\react-ecommerce\src\pages\AdminProducts.jsx", "JavaScript JSX", 0, 7, 0, 3, 10
"c:\Users\gk725\Desktop\Gautam\Ecommerce\react-ecommerce\src\pages\Checkout.jsx", "JavaScript JSX", 0, -5, 0, 0, -5
"c:\Users\gk725\Desktop\Gautam\Ecommerce\react-ecommerce\src\pages\Home.jsx", "JavaScript JSX", 0, 9, 0, -1, 8
"c:\Users\gk725\Desktop\Gautam\Ecommerce\react-ecommerce\src\pages\Personal.jsx", "JavaScript JSX", 0, -5, 0, -3, -8
"c:\Users\gk725\Desktop\Gautam\Ecommerce\react-ecommerce\src\pages\Profile.jsx", "JavaScript JSX", 0, 26, 0, 4, 30
"c:\Users\gk725\Desktop\Gautam\Ecommerce\react-ecommerce\src\pages\Settings.jsx", "JavaScript JSX", 0, 5, 0, 3, 8
"c:\Users\gk725\Desktop\Gautam\Ecommerce\react-ecommerce\src\pages\UpdatePersonal.jsx", "JavaScript JSX", 0, 5, 0, 3, 8
"c:\Users\gk725\Desktop\Gautam\Ecommerce\react-ecommerce\src\pages\User.jsx", "JavaScript JSX", 0, 6, 0, 0, 6
"c:\Users\gk725\Desktop\Gautam\Ecommerce\react-ecommerce\src\pages\UserProducts.jsx", "JavaScript JSX", 0, 7, 0, 3, 10
"Total", "-", 132, 664, 0, 62, 858